1111111111111111
1s00110000000001
1110100011111101
1000001010011101
1000001010110001
1111101010100101
1000001010100011
1011111010111001
1000001010100011
1000001010111001
100000000010000e
1111111111111111
